10 8 1 6
########
#      #
#   ####
# # ####
#   ####
#      #
# o    #
###    #
##  ## #
########